1 1 1 1 1 1 1 1 1 1 1 1 1 1 1 1 1 1 1 1 1 1 1 1 1 1 1 1 1 1 1 1
1 0 0 0 0 0 0 0 0 0 0 0 0 0 0 0 0 0 0 0 0 0 0 0 0 0 0 0 0 0 0 1
1 0 0 0 4 4 4 4 0 0 0 0 0 0 0 4 4 4 0 0 0 0 0 0 0 0 0 9 0 0 2 1
1 0 0 0 1 1 1 1 0 0 1 1 1 0 0 1 1 1 0 0 1 1 1 1 0 0 1 1 1 1 1 1
1 0 0 0 0 0 0 0 0 0 0 0 1 0 0 0 0 0 0 0 1 5 5 1 0 0 0 0 0 0 0 1
1 0 0 0 0 0 0 0 0 0 0 0 1 0 0 0 0 0 0 0 1 4 4 1 0 0 0 0 0 0 0 1
1 1 1 1 1 0 5 0 1 1 1 1 1 1 1 1 1 0 1 1 1 4 4 1 1 1 1 1 1 0 0 1
1 4 4 0 0 0 0 0 0 0 0 0 0 0 0 0 0 0 0 0 1 4 4 0 0 0 0 0 0 0 0 1
1 4 4 0 7 0 0 0 6 0 0 0 0 0 0 0 0 0 0 0 1 4 4 0 9 0 0 9 0 0 0 1
1 1 1 1 1 1 1 1 1 1 0 0 0 0 0 0 0 0 0 0 1 1 1 1 1 1 1 1 1 0 0 1
1 5 4 0 0 0 0 0 0 0 0 0 0 0 0 0 0 0 0 0 1 0 0 0 0 0 0 0 0 0 0 1
1 5 4 0 7 0 0 0 0 0 0 0 1 0 1 1 1 1 1 0 1 0 0 7 0 0 0 0 0 0 0 1
1 1 1 1 1 1 1 0 0 0 0 1 1 0 1 5 5 5 1 0 0 0 0 1 1 0 0 0 0 0 0 1
1 0 4 0 0 0 0 0 0 0 1 1 1 0 1 4 4 4 1 0 0 0 0 1 1 1 0 0 0 0 0 1
1 3 4 0 0 0 0 0 0 1 1 1 1 0 1 1 0 1 1 0 1 0 0 1 1 1 1 1 1 1 1 1
1 1 4 1 0 0 0 0 1 4 4 0 0 0 0 0 0 0 4 4 1 0 0 0 0 0 0 4 4 4 5 1
1 1 4 1 4 1 4 1 1 4 4 9 0 0 0 6 0 7 4 4 1 0 0 0 0 8 0 4 4 4 5 1
1 1 1 1 1 1 1 1 1 1 1 1 1 1 1 1 1 1 1 1 1 1 1 1 1 1 1 1 1 1 1 1
background2
20.0 24.0 30.0