1 1 1 1 1 1 1 1 1 1 1 1 1 1 1 1 1 1 1 1 1 1 1 1 1 1 1 1 1 1 1 1
1 1 0 0 0 0 0 0 1 1 1 1 1 0 0 4 4 4 4 4 0 0 1 1 1 1 1 0 0 0 1 1
1 5 0 0 0 0 0 0 0 1 1 1 0 0 1 1 1 1 1 1 1 0 0 1 1 1 0 0 0 0 0 1
1 5 0 0 0 4 4 4 0 0 1 0 0 0 0 6 0 0 0 6 0 0 0 0 1 0 0 1 0 1 0 1
1 1 1 1 0 1 1 1 0 0 1 0 1 1 1 1 1 1 1 1 1 1 1 0 1 0 1 1 0 1 1 1
1 0 0 1 0 0 1 0 0 0 1 0 0 1 0 0 0 0 0 0 0 1 0 0 1 0 0 1 0 1 5 1
1 3 0 1 0 0 1 0 0 4 1 4 0 1 0 0 4 4 4 0 0 1 0 0 1 0 0 1 0 0 5 1
1 1 0 1 0 1 1 0 0 1 1 1 0 1 0 1 1 1 1 1 0 1 0 1 1 1 0 1 0 0 5 1
1 0 0 1 0 0 1 0 0 0 1 0 0 1 0 0 0 0 1 0 0 1 0 0 0 0 0 1 0 1 1 1
1 0 0 9 0 0 1 4 0 0 1 0 4 1 0 0 0 2 1 0 0 1 0 0 0 0 0 1 0 0 0 1
1 1 1 1 1 1 1 1 0 0 1 0 1 1 1 1 1 1 1 0 1 1 1 1 1 1 1 1 0 0 0 1
1 0 0 0 0 0 0 0 0 0 1 0 0 4 0 0 0 0 4 0 0 1 1 1 0 0 0 1 1 1 0 1
1 0 0 0 8 0 0 8 0 5 1 5 0 4 0 9 0 0 4 0 5 1 1 0 0 0 0 0 0 0 0 1
1 4 4 1 1 1 1 1 1 1 1 1 1 1 1 1 1 1 1 1 1 1 4 4 4 4 4 4 4 4 4 1
1 1 4 4 1 4 4 4 1 4 4 4 1 1 1 4 4 4 1 1 1 4 4 4 1 1 1 4 4 4 1 1
1 1 1 4 4 4 1 4 4 4 1 4 4 1 4 4 1 4 4 1 4 4 4 1 1 4 4 4 4 1 1 1
1 1 1 1 4 1 1 1 4 1 1 1 4 4 4 1 1 1 4 4 4 4 1 1 1 4 4 4 1 1 1 1
1 1 1 1 1 1 1 1 1 1 1 1 1 1 1 1 1 1 1 1 1 1 1 1 1 1 1 1 1 1 1 1
background4
230.0 193.0 227.0