1 1 1 1 1 1 1 1 1 1 1 1 1 1 1 1 1 1 1 1 1 1 1 1 1 1 1 1 1 1 1 1
1 1 1 1 0 0 0 0 0 0 0 0 0 0 0 5 5 0 0 0 0 0 0 0 0 0 0 0 1 1 1 1
1 1 1 0 0 0 0 0 8 0 0 6 0 0 0 5 5 0 0 6 0 0 0 8 0 0 0 0 0 1 1 1
1 1 0 0 0 1 1 1 1 1 1 1 1 1 1 1 1 1 1 1 1 1 1 1 1 1 1 0 0 0 1 1
1 0 0 0 1 1 1 0 0 0 0 0 0 5 1 1 1 1 5 0 0 0 0 0 0 1 1 1 0 0 0 1
1 0 0 1 1 1 0 0 0 0 0 0 0 5 5 1 1 5 5 0 0 0 0 0 0 0 1 1 1 0 0 1
1 0 1 1 1 0 0 1 1 1 0 0 1 1 1 1 1 1 1 1 0 0 1 1 1 0 0 1 1 1 0 1
1 0 0 1 0 0 0 0 0 0 0 0 0 0 0 0 0 0 0 0 0 0 0 0 0 0 0 0 0 0 0 1
1 0 0 1 0 0 0 0 7 0 0 0 0 7 0 0 0 0 7 0 0 0 0 7 0 0 0 0 0 0 0 1
1 1 0 1 0 1 1 1 1 1 1 1 1 1 1 1 1 1 1 1 1 1 1 1 1 1 1 1 1 1 1 1
1 0 0 1 0 0 0 0 0 0 0 0 0 0 0 1 1 0 0 0 0 0 0 0 0 0 0 0 0 0 0 1
1 0 0 1 0 0 0 0 8 0 0 8 0 0 0 0 0 0 0 0 8 0 0 8 0 0 0 0 0 0 0 1
1 0 1 1 4 4 1 1 1 1 1 1 1 1 5 5 5 5 1 1 1 1 1 1 1 1 4 4 1 1 0 1
1 0 0 1 1 1 1 0 0 0 0 0 0 1 1 1 1 1 1 0 0 0 0 0 0 1 1 1 1 0 0 1
1 1 0 0 0 0 0 0 0 7 0 0 0 0 1 1 1 1 0 0 0 0 7 0 0 0 0 0 0 0 1 1
1 1 1 0 0 0 0 0 1 1 1 0 0 0 0 1 1 0 0 0 0 1 1 1 0 0 0 0 0 1 1 1
1 1 1 1 4 5 4 1 1 1 1 1 0 2 0 1 1 0 3 0 1 1 1 1 1 4 5 4 1 1 1 1
1 1 1 1 1 1 1 1 1 1 1 1 1 1 1 1 1 1 1 1 1 1 1 1 1 1 1 1 1 1 1 1
background5
149.0 14.0 14.0